Adana: Aladag, Ceyhan, Cukurova, Feke, Imamoglu, Karaisali, Karatas, Kozan, Pozanti, Saimbeyli, Saricam, Seyhan, Tufanbeyli, Yumurtalik, Yuregir
Adiyaman: Besni, Celikhan, Gerger, Golbasi, Kahta, Samsat, Sincik, Tut
Afyonkarahisar: Basmakci, Bayat, Bolvadin, Cay, Cobanlar, Dazkiri, Dinar, Emirdag, Evciler, Hocalar, Ihsaniye, Iscehisar, Kiziloren, Sandikli, Sinanpasa, Suhut, Afyonkarahisar-Merkez
Agri: Diyadin, Dogubayazit, Eleskirt, Hamur, Patnos, Taslicay, Tutak, Agri-Merkez
Amasya: Goynucek, Gumushacikoy, Hamamozu, Merzifon, Suluova, Tasova, Amasya-Merkez
Ankara: Altindag, Ayas, Bala, Beypazari, Camlidere, Cankaya, Cubuk, Elmadag, Etimesgut, Evren, Golbasi, Gudul, Haymana, Kalecik, Kahramankazan, Kecioren, Kizilcahamam, Mamak, Nallihan, Polatli, Pursaklar, Sincan, Sereflikochisar, Yenimahalle
Antalya: Akseki, Aksu, Alanya, Demre, Dosemealti, Elmali, Finike, Gazipasa, Gundogmus, Ibradi, Kas, Kemer, Kepez, Konyaalti, Korkuteli, Kumluca, Manavgat, Muratpasa, Serik
Artvin: Ardanuc, Arhavi, Borcka, Hopa, Kemalpasa, Murgul, Savsat, Yusufeli
Aydin: Bozdogan, Buharkent, Cine, Didim, Efeler, Germencik, Incirliova, Karacasu, Karpuzlu, Kocarli, Kosk, Kusadasi, Kuyucak, Nazilli, Soke, Sultanhisar, Yenipazar
Balikesir: Altieylul, Ayvalik, Balya, Bandirma, Bigadic, Burhaniye, Dursunbey, Edremit, Erdek, Gomec, Gonen, Havran, Ivrindi, Karesi, Kepsut, Manyas, Marmara, Savastepe, Sindirgi, Susurluk
Bilecik: Bozuyuk, Golpazari, Inhisar, Osmaneli, Pazaryeri, Sogut, Yenipazar, Bilecik-Merkez
Bingol: Adakli, Genc, Karliova, Kigi, Solhan, Yayladere, Yedisu, Bingol-Merkez
Bitlis: Adilcevaz, Ahlat, Guroymak, Hizan, Mutki, Tatvan, Bitlis-Merkez
Bolu: Dortdivan, Gerede, Goynuk, Kibriscik, Mengen, Mudurnu, Seben, Yenicaga, Bolu-Merkez
Burdur: Aglasun, Altinyayla, Bucak, Cavdir, Celtikci, Golhisar, Karamanli, Kemer, Tefenni, Yesilova, Burdur-Merkez
Bursa: Buyukorhan, Gemlik, Gursu, Harmancik, Inegol, Iznik, Karacabey, Keles, Kestel, Mudanya, Mustafakemalpasa, Nilufer, Orhaneli, Orhangazi, Osmangazi, Yenisehir, Yildirim
Canakkale: Ayvacik, Bayramic, Biga, Bozcaada, Can, Eceabat, Ezine, Gelibolu, Gokceada, Lapseki, Yenice, Canakkale-Merkez
Cankiri: Atkaracalar, Bayramoren, Cerkes, Eldivan, Ilgaz, Kizilirmak, Korgun, Kursunlu, Orta, Sabanozu, Yaprakli, Cankiri-Merkez
Corum: Alaca, Bayat, Bogazkale, Dodurga, Iskilip, Kargi, Lacin, Mecitozu, Oguzlar, Ortakoy, Osmancik, Sungurlu, Ugurludag, Corum-Merkez
Denizli: Acipayam, Babadag, Baklan, Bekilli, Beyagac, Bozkurt, Buldan, Cal, Cameli, Cardak, Civril, Guney, Honaz, Kale, Merkezefendi, Pamukkale, Saraykoy, Serinhisar, Tavas
Diyarbakir: Baglar, Bismil, Cermik, Cinar, Cungus, Dicle, Egil, Ergani, Hani, Hazro, Kayapinar, Kocakoy, Lice, Silvan, Sur, Yenisehir
Edirne: Enez, Havsa, Ipsala, Kesan, Lalapasa, Meric, Suloglu, Uzunkopru, Edirne-Merkez
Elazig: Agin, Alacakaya, Aricak, Baskil, Karakocan, Keban, Kovancilar, Maden, Palu, Sivrice, Elazig-Merkez
Erzincan: Cayirli, Ilic, Kemah, Kemaliye, Otlukbeli, Refahiye, Tercan, Uzumlu, Erzincan-Merkez
Erzurum: Askale, Aziziye, Cat, Hinis, Horasan, Ispir, Karacoban, Karayazi, Koprukoy, Narman, Oltu, Olur, Palandoken, Pasinler, Pazaryolu, Senkaya, Tekman, Tortum, Uzundere, Yakutiye
Eskisehir: Alpu, Beylikova, Cifteler, Gunyuzu, Han, Inonu, Mahmudiye, Mihalgazi, Mihaliccik, Odunpazari, Seyitgazi, Sivrihisar, Tepebasi
Gaziantep: Araban, Islahiye, Karkamis, Nizip, Nurdagi, Oguzeli, Sahinbey, Sehitkamil, Yavuzeli
Giresun: Alucra, Bulancak, Camoluk, Canakci, Dereli, Dogankent, Espiye, Eynesil, Gorele, Guce, Kesap, Piraziz, Sebinkarahisar, Tirebolu, Yaglidere, Giresun-Merkez
Gumushane: Kelkit, Kose, Kurtun, Siran, Torul, Gumushane-Merkez
Hakkari: Cukurca, Derecik, Semdinli, Yuksekova, Hakkari-Merkez
Hatay: Altinozu, Antakya, Arsuz, Belen, Defne, Dortyol, Erzin, Hassa, Iskenderun, Kirikhan, Kumlu, Payas, Reyhanli, Samandag, Yayladagi
Igdir: Aralik, Karakoyunlu, Tuzluca, Igdir-Merkez
Isparta: Aksu, Atabey, Egirdir, Gelendost, Gonen, Keciborlu, Senirkent, Sutculer, Sarkikaraagac, Uluborlu, Yalvac, Yenisarbademli, Isparta-Merkez
Istanbul: Adalar, Arnavutkoy, Atasehir, Avcilar, Bagcilar, Bahcelievler, Bakirkoy, Basaksehir, Bayrampasa, Besiktas, Beykoz, Beylikduzu, Beyoglu, Buyukcekmece, Catalca, Cekmekoy, Esenler, Esenyurt, Eyupsultan, Fatih, Gaziosmanpasa, Gungoren, Kadikoy, Kagithane, Kartal, Kucukcekmece, Maltepe, Pendik, Sancaktepe, Sariyer, Silivri, Sultanbeyli, Sultangazi, Sile, Sisli, Tuzla, Umraniye, Uskudar, Zeytinburnu
Izmir: Aliaga, Balcova, Bayindir, Bayrakli, Bergama, Beydag, Bornova, Buca, Cesme, Cigli, Dikili, Foca, Gaziemir, Guzelbahce, Karabaglar, Karaburun, Karsiyaka, Kemalpasa, Kinik, Kiraz, Konak, Menderes, Menemen, Narlidere, Odemis, Seferihisar, Selcuk, Tire, Torbali, Urla
Kahramanmaras: Afsin, Andirin, Caglayancerit, Dulkadiroglu, Ekinozu, Elbistan, Goksun, Nurhak, Onikisubat, Pazarcik, Turkoglu
Karabuk: Eflani, Eskipazar, Ovacik, Safranbolu, Yenice, Karabuk-Merkez
Karaman: Ayranci, Basyayla, Ermenek, Kazimkarabekir, Sariveliler, Karaman-Merkez
Kars: Akyaka, Arpacay, Digor, Kagizman, Sarikamis, Selim, Susuz, Kars-Merkez
Kastamonu: Abana, Agli, Arac, Azdavay, Bozkurt, Cide, Catalzeytin, Daday, Devrekani, Doganyurt, Hanonu, Ihsangazi, Inebolu, Kure, Pinarbasi, Seydiler, Senpazar, Taskopru, Tosya, Kastamonu-Merkez
Kayseri: Akkisla, Bunyan, Develi, Felahiye, Hacilar, Incesu, Kocasinan, Melikgazi, Ozvatan, Pinarbasi, Sarioglan, Sariz, Talas, Tomarza, Yahyali, Yesilhisar
Kirikkale: Bahsili, Baliseyh, Celebi, Delice, Karakecili, Keskin, Sulakyurt, Yahsihan, Kirikkale-Merkez
Kirklareli: Babaeski, Demirkoy, Kofcaz, Luleburgaz, Pehlivankoy, Pinarhisar, Vize, Kirklareli-Merkez
Kirsehir: Akcakent, Akpinar, Boztepe, Cicekdagi, Kaman, Mucur, Kirsehir-Merkez
Kilis: Elbeyli, Musabeyli, Polateli, Kilis-Merkez
Kocaeli: Basiskele, Cayirova, Darica, Derince, Dilovasi, Gebze, Golcuk, Izmit, Kandira, Karamursel, Kartepe, Korfez
Konya: Ahirli, Akoren, Aksehir, Altinekin, Beysehir, Bozkir, Celtik, Cihanbeyli, Cumra, Derbent, Derebucak, Doganhisar, Emirgazi, Eregli, Guneysinir, Hadim, Halkapinar, Huyuk, Ilgin, Kadinhani, Karapinar, Karatay, Kulu, Meram, Sarayonu, Selcuklu, Seydisehir, Taskent, Tuzlukcu, Yalihuyuk, Yunak
Kutahya: Altintas, Aslanapa, Cavdarhisar, Domanic, Dumlupinar, Emet, Gediz, Hisarcik, Pazarlar, Saphane, Simav, Tavsanli, Kutahya-Merkez
Malatya: Akcadag, Arapgir, Arguvan, Battalgazi, Darende, Dogansehir, Doganyol, Hekimhan, Kale, Kuluncak, Puturge, Yazihan, Yesilyurt
Manisa: Ahmetli, Akhisar, Alasehir, Demirci, Golmarmara, Gordes, Kirkagac, Koprubasi, Kula, Salihli, Sarigol, Saruhanli, Selendi, Soma, Sehzadeler, Turgutlu, Yunusemre
Mardin: Artuklu, Dargecit, Derik, Kiziltepe, Mazidagi, Midyat, Nusaybin, Omerli, Savur, Yesilli
Mersin: Anamur, Aydincik, Bozyazi, Camliyayla, Erdemli, Gulnar, Mezitli, Mut, Silifke, Tarsus, Toroslar, Yenisehir, Akdeniz
Mugla: Bodrum, Dalaman, Datca, Fethiye, Kavaklidere, Koycegiz, Marmaris, Mentese, Milas, Ortaca, Seydikemer, Ula, Yatagan
Mus: Bulanik, Haskoy, Korkut, Malazgirt, Varto, Mus-Merkez
Nevsehir: Avanos, Derinkuyu, Gulsehir, Hacibektas, Kozakli, Urgup, Nevsehir-Merkez
Nigde: Altunhisar, Bor, Camardi, Ciftlik, Ulukisla, Nigde-Merkez
Ordu: Akkus, Altinordu, Aybasti, Camas, Catalpinar, Caybasi, Fatsa, Golkoy, Gulyali, Gurgentepe, Ikizce, Kabaduz, Kabatas, Korgan, Kumru, Mesudiye, Persembe, Ulubey, Unye
Osmaniye: Bahce, Duzici, Hasanbeyli, Kadirli, Sumbas, Toprakkale, Osmaniye-Merkez
Rize: Ardesen, Camlihemsin, Cayeli, Derepazari, Findikli, Guneysu, Hemsin, Ikizdere, Kalkandere, Pazar, Rize-Merkez
Sakarya: Adapazari, Akyazi, Arifiye, Erenler, Ferizli, Geyve, Hendek, Karapurcek, Karasu, Kaynarca, Kocaali, Pamukova, Sapanca, Serdivan, Sogutlu, Tarakli
Samsun: Alacam, Asarcik, Atakum, Ayvacik, Bafra, Canik, Carsamba, Havza, Ilkadim, Kavak, Ladik, Salipazari, Tekkekoy, Terme, Vezirkopru, Yakakent
Siirt: Baykan, Eruh, Kurtalan, Pervari, Sirvan, Tillo, Siirt-Merkez
Sinop: Ayancik, Boyabat, Dikmen, Duragan, Erfelek, Gerze, Sarayduzu, Turkeli, Sinop-Merkez
Sivas: Akincilar, Altinyayla, Divrigi, Dogansar, Gemerek, Golova, Gurun, Hafik, Imranli, Kangal, Koyulhisar, Susehri, Sarkisla, Ulas, Yildizeli, Zara, Sivas-Merkez
Sanliurfa: Akcakale, Birecik, Bozova, Ceylanpinar, Eyyubiye, Halfeti, Haliliye, Harran, Karakopru, Siverek, Suruc, Viransehir
Sirnak: Beytussebap, Cizre, Guclukonak, Idil, Silopi, Uludere, Sirnak-Merkez
Tekirdag: Cerkezkoy, Corlu, Ergene, Hayrabolu, Kapakli, Malkara, Marmaraereglisi, Muratli, Saray, Suleymanpasa, Sarkoy
Tokat: Almus, Artova, Basciftlik, Erbaa, Niksar, Pazar, Resadiye, Sulusaray, Turhal, Yesilyurt, Zile, Tokat-Merkez
Trabzon: Akcaabat, Arakli, Arsin, Besikduzu, Carsibasi, Caykara, Dernekpazari, Duzkoy, Hayrat, Koprubasi, Macka, Of, Ortahisar, Surmene, Salpazari, Tonya, Vakfikebir, Yomra
Tunceli: Cemisgezek, Hozat, Mazgirt, Nazimiye, Ovacik, Pertek, Pulumur, Tunceli-Merkez
Usak: Banaz, Esme, Karahalli, Sivasli, Ulubey, Usak-Merkez
Van: Bahcesaray, Baskale, Caldiran, Catak, Edremit, Ercis, Gevas, Gurpinar, Ipekyolu, Muradiye, Ozalp, Saray, Tusba
Yalova: Altinova, Armutlu, Cinarcik, Ciftlikkoy, Termal, Yalova-Merkez
Yozgat: Akdagmadeni, Aydincik, Bogazliyan, Candir, Cayiralan, Cekerek, Kadisehri, Saraykent, Sarikaya, Sorgun, Sefaatli, Yenifakili, Yerkoy, Yozgat-Merkez
Zonguldak: Alapli, Caycuma, Devrek, Eregli, Gokcebey, Zonguldak-Merkez
Aksaray: Agacoren, Eskil, Gulagac, Guzelyurt, Ortakoy, Sariyahsi, Sultanhani, Aksaray-Merkez
Bayburt: Aydintepe, Demirozu, Bayburt-Merkez
Batman: Besiri, Gercus, Hasankeyf, Kozluk, Sason, Batman-Merkez
Ardahan: Cildir, Damal, Gole, Hanak, Posof, Ardahan-Merkez
